0 0 0 0 0 0 5
0 0 0 0 0 0 5
0 3 3 1 0 0 4
0 2 2 1 0 1 5
0 0 0 1 0 1 5
0 0 2 2 0 1 5