0 0 2 2 1 0 5
0 0 0 0 1 1 5
3 3 1 0 1 1 4
0 0 1 2 2 0 5
1 0 0 2 2 2 5
1 0 0 2 2 0 5