0 2 2 0 1 0 5
1 0 2 2 1 0 5
1 3 3 0 1 0 4
0 0 1 0 2 2 5
0 0 1 0 0 0 5
0 0 1 0 0 0 5