0 0 0 0 0 0 5
0 2 2 0 1 0 5
3 3 1 0 1 0 4
2 2 1 0 1 0 5
0 1 0 0 0 0 5
0 1 2 2 2 0 5