0 0 0 1 0 0 5
0 0 0 1 0 0 5
0 3 3 1 0 1 4
1 2 2 2 0 1 5
1 0 1 0 2 2 5
0 0 1 2 2 2 5