5 5 2 2 1 0 5
0 2 2 1 1 0 5
3 3 0 1 0 1 4
0 0 0 2 2 1 5
0 1 1 2 2 1 5
0 1 1 2 2 2 5