0 0 0 2 2 2 5
0 0 0 0 1 0 5
3 3 0 1 1 0 4
0 0 0 1 1 0 5
0 1 1 1 0 0 5
0 1 1 2 2 0 5