1 1 0 1 1 1 5
1 1 0 1 1 1 5
3 3 0 1 1 1 4
0 0 0 2 2 2 5
2 2 0 0 0 0 5
0 0 0 0 0 0 5