0 0 0 0 1 1 5
0 0 0 0 1 1 5
0 3 3 0 1 1 4
0 1 0 0 2 2 5
0 1 0 2 2 2 5
0 0 2 2 0 0 5